43 13 13 13 13 13 13 13 13 13 13 13 13 13 13 13 13 13 13 13 13 13 13 13 13 13 13 13 13 42
11 00 00 00 00 00 00 00 00 00 00 00 00 00 00 00 00 00 00 00 00 00 00 00 00 00 00 00 00 12
11 00 54 51 00 54 51 00 54 51 00 54 14 14 14 14 14 14 51 00 54 51 00 54 51 00 54 51 00 12
11 00 12 11 00 12 11 00 12 11 00 12 43 13 13 13 13 42 11 00 12 11 00 12 11 00 12 11 00 12
11 00 12 11 00 12 11 00 12 11 00 12 11 00 00 00 00 12 11 00 12 11 00 12 11 00 12 11 00 12
11 00 12 11 00 12 11 00 12 11 00 12 11 00 54 51 00 12 11 00 12 11 00 12 11 00 12 11 00 12
11 00 52 53 00 12 11 00 52 53 00 52 53 00 12 11 00 52 53 00 52 53 00 12 11 00 52 53 00 12
11 00 00 00 00 12 11 00 00 00 00 00 00 00 12 11 00 00 00 00 00 00 00 12 11 00 00 00 00 12
11 00 54 14 14 44 11 00 54 14 14 14 51 00 12 11 00 54 14 14 14 51 00 12 41 14 14 51 00 12
11 00 52 13 13 13 53 00 52 13 13 13 53 00 52 53 00 52 13 13 13 53 00 52 13 13 13 53 00 12
11 00 00 00 00 00 00 00 00 00 00 00 00 00 00 00 00 00 00 00 00 00 00 00 00 00 00 00 00 12
11 00 54 14 14 14 51 00 54 51 00 54 14 14 14 14 14 14 51 00 54 51 00 54 14 14 14 51 00 12
11 00 12 60 60 60 11 00 12 11 00 12 60 60 60 60 60 60 11 00 12 11 00 12 60 60 60 11 00 12
11 00 52 13 13 42 11 00 52 53 00 52 13 13 13 13 13 13 53 00 52 53 00 12 43 13 13 53 00 12
11 00 00 00 00 12 11 00 00 00 00 00 00 00 00 00 00 00 00 00 00 00 00 12 11 00 00 00 00 12
11 00 54 51 00 12 41 14 14 51 00 54 14 51 00 00 54 14 51 00 54 14 14 44 11 00 54 51 00 12
11 00 12 11 00 12 43 13 13 53 00 12 80 80 80 80 80 80 11 00 52 13 13 42 11 00 12 11 00 12
11 00 12 11 00 12 11 00 00 00 00 12 80 80 80 80 80 80 11 00 00 00 00 12 11 00 12 11 00 12
11 00 12 11 00 12 11 00 54 51 00 12 80 80 80 80 80 80 11 00 54 51 00 12 11 00 12 11 00 12
11 00 12 11 00 52 53 00 12 11 00 52 13 13 42 43 13 13 53 00 12 11 00 52 53 00 12 11 00 12
11 00 12 11 00 00 00 00 12 11 00 00 00 00 12 11 00 00 00 00 12 11 00 00 00 00 12 11 00 12
11 00 12 11 00 54 51 00 12 11 00 54 51 00 12 11 00 54 51 00 12 11 00 54 51 00 12 11 00 12
11 00 12 11 00 12 11 00 52 53 00 52 53 00 12 11 00 52 53 00 52 53 00 12 11 00 12 11 00 12
11 00 12 11 00 12 11 00 00 00 00 00 00 00 12 11 00 00 00 00 00 00 00 12 11 00 12 11 00 12
11 00 12 11 00 12 11 00 54 14 14 14 51 00 12 11 00 54 14 14 14 51 00 12 11 00 12 11 00 12
11 00 52 53 00 52 53 00 52 13 13 42 11 00 52 53 00 12 43 13 13 53 00 52 53 00 52 53 00 12
11 00 00 00 00 00 00 00 00 00 00 12 11 00 00 00 00 12 11 00 00 00 00 00 00 00 00 00 00 12
41 14 14 14 14 14 14 14 14 51 00 12 11 00 54 51 00 12 11 00 54 14 14 14 14 14 14 14 14 44
60 60 60 43 13 13 13 13 13 53 00 12 11 00 12 11 00 12 11 00 52 13 13 13 13 13 42 60 60 60
60 60 60 11 00 00 00 00 00 00 00 12 11 00 12 11 00 12 11 70 00 00 00 00 00 00 12 60 60 60
60 60 60 11 00 54 14 14 14 51 00 12 11 00 12 11 00 12 11 00 54 14 14 14 51 00 12 60 60 60
60 60 60 11 00 12 60 60 60 11 00 52 53 00 52 53 00 52 53 00 12 60 60 60 11 00 12 60 60 60
60 60 60 11 00 12 60 60 60 11 00 00 00 00 00 00 00 00 00 00 12 60 60 60 11 00 12 60 60 60
60 60 60 41 14 44 60 60 60 41 14 14 14 14 14 14 14 14 14 14 44 60 60 60 41 14 44 60 60 60